13 13 1.5 1.5 0
#############
#   #   #   #
# #   #   # #
# ## ### ## #
#  # #    # #
## # ###### #
#  # #      #
# ## # ## ###
# #  ###   ##
# ##  #     #
#  # ###   ##
# ##   ## ###
#############
